|dir
mechanism|механизм
rats|крысы
wolf|волк
caprice|каприз
stained|витраж
hospice|приют
sss|сделать самое сложное
race|гонка
google
valued|ценное
device|устройство
2girl
corngrill|кукуруза и аэрогриль
try-finally
observer|наблюдатель
vampire|вампир
mercury|ртуть
black-hole-sun
os_1|ОС №1
bees|пчёлы
dynbasis|диноснова
text|текст
island|остров
cat-girl|девушка-кошка
glass
corals|кораллы
carrotoid|морквоид
reality|reality
virus|вирус
taxi|такси
gunners|автоматчики
balcony|балкон
